00011000000000
00000000000000
00000000000000
11000000000100
11000000001100
11000000001100
11000000001100
11000000001100
11000000000000
00000000000000