000110000000000001
000000000000000001
000000000000000001
110000000001000001
110000000011000001
110000000011000001
110000000011000011
110000000011000011
110000000000000011
000000000000000011
111111111111111111
111111111111111111
111111111111111111