0001100000
0000000000
0000000000
1100000000
1100000000
1100000000
1100000000
1100000000
1100000000